WWWWWWWWWWWWWWWWWWWWWWWWWWWWWW
WFFFFFFFFFFFFFFFFFFFFFFFFFFFFW
WFFFFFFFFFFFFFFFFFFFFFFFFFFFFW
WFFWFFFFFFFFFWFFFFFWWWWWWWFFFW
WFFWFFFFFFFFFWFFFFFWFFFFFFFFFW
WFFFWFFFWFFFWFFFFFFWWWWWWFFFFW
WFFFFWFWFWFWFFFFFFFWFFFFFFFFFW
WFFFFFWFFFWFFFFFFFFWWWWWWWFFFW
WFFFFFFFFFFFFFFFFFFFFFFFFFFFFW
WFFFWWWWWWWFFFFFFFFWWWWFFFFFFW
WFFFWFFFFFFFFFFFFFFWFFFWFFFFFW
WFFFWWWWWWFFFFFFFFFWFFFFWFFFFW
WFFFWFFFFFFFFFFFFFFWFFFWFFFFFW
WFFFWWWWWWWFFFFFFFFWWWWFFFFFFW
WFFFFFFFFFFFFFFFFFFFFFFFFFFFFW
WFFFFFFFFFFFFFFFFFFFFFFFFFFFFW
WFFFFFFFFFFFFFFFFFFFFFFFFFFFFW
WFFFFFFFFFFFFFFFFFFFFFFFFFFFFW
WFFFFFFFFFFFFFFFFFFFFFFFFFFFFW
WFFFFFFFFFFFFFFFFFFFFFFFFFFFFW
WFFFFFFFFFFFFFFFFFFFFFFFFFFFFW
WFFFFFFFFFFFFFFFFFFFFFFFFFFFFW
WFFFFFFFFFFFFFFFFFFFFFFFFFFFFW
WFFFFFFFFFFFFFFFFFFFFFFFFFFFFW
WFFFFFFFFFFFFFFFFFFFFFFFFFFFFW
WFFFFFFFFFFFFFFFFFFFFFFFFFFFFW
WFFFFFFFFFFFFFFFFFFFFFFFFFFFFW
WFFFFFFFFFFFFFFFFFFFFFFFFFFFFW
WFFFFFFFFFFFFFFFFFFFFFFFFFFFFW
WWWWWWWWWWWWWWWWWWWWWWWWWWWWWW