FFFFFFFFFFFFFFFFFFFFFFFFFFFFFFF
FOFOFOFOFOFOFOFOFOFOFOFOFOFOFOF
FFFFFFFFFFFFFFFFFFFFFFFFFFFFFFF
WOWOWOFOFOFOFOFOFOFOFOFOFOFOFOF
FFFFFFWWWWFWWWFFFFFFFFFFFFFFFFF
FOFOFOFOFOFOWOFOFOFOFOFOFOFOFOF
FFFFFFFFFFFFWWWFFFFFFFFFFFFFFFF
FOFOFOFOFOFOWOFOFOFOFOFOFOFOFOF
FFFFFFFFFFFFFFFFFFFFFFFFFFFFFFF
FOFOFOFOFOFOFOFOFOFOFOFOFOFOFOF
FFFFFFFFFFFFFFFFFFFFFFFFFFFFFFF
FOFOFOFOFOFOFOFOFOFOFOFOFOFOFOF
FFFFFFFFFFFFFFFFFFFFFFFFFFFFFFF
FOFOFOFOFOFOFOFOFOFOFOFOFOFOFOF
FFFFFFFFFFFFFFFFFFFFFFFFFFFFFFF
FOFOFOFOFOFOFOFOFOFOFOFOFOFOFOF
FFFFFFFFFFFFFFFFFFFFFFFFFFFFFFF
FOFOFOFOFOFOFOFOFOFOFOFOFOFOFOF
FFFFFFFFFFFFFFFFFFFFFFFFFFFFFFF
FOFOFOFOFOFOFOFOFOFOFOFOFOFOFOF
FFFFFFFFFFFFFFFFFFFFFFFFFFFFFFF
FOFOFOFOFOFOFOFOFOFOFOFOFOFOFOF
FFFFFFFFFFFFFFFFFFFFFFFFFFFFFFF
FOFOFOFOFOFOFOFOFOFOFOFOFOFOFOF
FFFFFFFFFFFFFFFFFFFFFFFFFFFFFFF
FOFOFOFOFOFOFOFOFOFOFOFOFOFOFOF
FFFFFFFFFFFFFFFFFFFFFFFFFFFFFFF
FOFOFOFOFOFOFOFOFOFOFOFOFOFOFOF
FFFFFFFFFFFFFFFFFFFFFFFFFFFFFFF
FOFOFOFOFOFOFOFOFOFOFOFOFOFOFOF
FFFFFFFFFFFFFFFFFFFFFFFFFFFFFOF
