FFWWWWWWWWWWWWWWWWFF
FOWOWOWOWOWOWOWOWOFO
WWWWWWWWWWWWWWWWWWWW
WOWOWOWOWOWOWOWOWOWO
WWWWWWWWWWWWWWWWWWWW
WOWOWOWOWOWOWOWOWOWO
WWWWWWWWWWWWWWWWWWWW
WOWOWOWOWOWOWOWOWOWO
WWWWWWWWWWWWWWWWWWWW
WOWOWOWOWOWOWOWOWOWO
WWWWWWWWWWWWWWWWWWWW
WOWOWOWOWOWOWOWOWOWO
WWWWWWWWWWWWWWWWWWWW
WOWOWOWOWOWOWOWOWOWO
WWWWWWWWWWWWWWWWWWWW
WOWOWOWOWOWOWOWOWOWO
WWWWWWWWWWWWWWWWWWWW
WOWOWOWOWOWOWOWOWOWO
WWWWWWWWWWWWWWWWWWWW
WOWOWOWOWOWOWOWOWOWO