FFFFFFFFFFFFFFFFFFFF
FOFOFOFOFOFOFOFOFOFO
FFFFFFFFFFFFFFFFFFFF
WOWOWOFOFOFOFOFOFOFO
FFFFFFWWWWFWWWFFFFFF
FOFOFOFOFOFOWOFOFOFO
FFFFFFFFFFFFWWWFFFFF
FOFOFOFOFOFOWOFOFOFO
FFFFFFFFFFFFFFFFFFFF
FOFOFOFOFOFOFOFOFOFO
FFFFFFFFFFFFFFFFFFFF
FOFOFOFOFOFOFOFOFOFO
FFFFFFFFFFFFFFFFFFFF
FOFOFOFOFOFOFOFOFOFO
FFFFFFFFFFFFFFFFFFFF
FOFOFOFOFOFOFOFOFOFO
FFFFFFFFFFFFFFFFFFFF
FOFOFOFOFOFOFOFOFOFO
FFFFFFFFFFFFFFFFFFFF
FOFOFOFOFOFOFOFOFOFO
FFFFFFFFFFFFFFFFFFFF