FFWWWWWWWWWWWWWWWWWWWWWWWWFF
FOWOWOWOWOWOWOWOWOWOWOWOWOFO
WWWWWWWWWWWWWWWWWWWWWWWWWWWW
WOWOWOWOWOWOWOWOWOWOWOWOWOWO
WWWWWWWWWWWWWWWWWWWWWWWWWWWW
WOWOWOWOWOWOWOWOWOWOWOWOWOWO
WWWWWWWWWWWWWWWWWWWWWWWWWWWW
WOWOWOWOWOWOWOWOWOWOWOWOWOWO
WWWWWWWWWWWWWWWWWWWWWWWWWWWW
WOWOWOWOWOWOWOWOWOWOWOWOWOWO
WWWWWWWWWWWWWWWWWWWWWWWWWWWW
WOWOWOWOWOWOWOWOWOWOWOWOWOWO
WWWWWWWWWWWWWWWWWWWWWWWWWWWW
WOWOWOWOWOWOWOWOWOWOWOWOWOWO
WWWWWWWWWWWWWWWWWWWWWWWWWWWW
WOWOWOWOWOWOWOWOWOWOWOWOWOWO
WWWWWWWWWWWWWWWWWWWWWWWWWWWW
WOWOWOWOWOWOWOWOWOWOWOWOWOWO
WWWWWWWWWWWWWWWWWWWWWWWWWWWW
WOWOWOWOWOWOWOWOWOWOWOWOWOWO
WWWWWWWWWWWWWWWWWWWWWWWWWWWW
WOWOWOWOWOWOWOWOWOWOWOWOWOWO
WWWWWWWWWWWWWWWWWWWWWWWWWWWW
WOWOWOWOWOWOWOWOWOWOWOWOWOWO
WWWWWWWWWWWWWWWWWWWWWWWWWWWW
WOWOWOWOWOWOWOWOWOWOWOWOWOWO
WWWWWWWWWWWWWWWWWWWWWWWWWWWW
WOWOWOWOWOWOWOWOWOWOWOWOWOWO